xfff___________________________________x
x#########################__############
x______ff_______________________________
#e_____ff_______________________________
________________________________________
________________________________________
________________________________________
_______ff_______________________________
_______ff_______________________________
x#################x####################x
x__ff___ff___ff___x___________________wx
x__ff___ff___ff___x____________________x
x__ff___ff___ff___x____________________x
x__ff___ff___ff___x_h_____e____________x
x__ff___ff___ff___x____________________x
x________f___h____x____________________x
x________ff_______x____________________x
x######f___#######x____________________x
x_____h___________x____________________x
x_________________x____________________x
x_________________x____________________x
x_________________#____________________x
x_______________h______________________x
x______________________________________x
x______________________________________x
x_h_______________x____________________x
x_p_______________x_______________e____x
x_________________x____________________x
########################################