________________________________________
________________________________________
________________________________________
________________________________________
________________________________________
________________________________________
________________________________________
________________________________________
________________________________________
########################################
#__ff___ff___ff___#___________________w#
#__ff___ff___ff___#____________________#
#__ff___ff___ff___#____________________#
#__ff___ff___ff___#_______e____________#
#__ff___ff___ff___#____________________#
#________f___h____#____________________#
#________ff_______#____________________#
#######f___########____________________#
#_____h___________#____________________#
#_________________#____________________#
#_________________#____________________#
#_________________#____________________#
#_______________h______________________#
#______________________________________#
#______________________________________#
#_h_______________#____________________#
#_p_______________#_______________e____#
#_________________#____________________#
########################################