_________________________#_____________#
__h__e___________________#_____________#
__w______________________#_____________#
_______________________________________#
_______________________________________#
_______________________________________#
_________________________#_____________#
_________________________#_____________#
_________________________#_____________#
_________________________#_____________#
####ff##################################
_____________________f____________#____#
_____________________f____________#____#
_____________________f____________#____#
_______________________________________#
_______________________________________#
f______________________________________#
ff________________________________#____#
fff_______________________________#____#
#############################__#########
_______________________________________#
_______________________________________#
_______________________________________#
_______________________________________#
#######__###___________________________#
___________#___________________________#
___________#___________________________#
___________#___________h___P___________#
___________#___________________________#
___________#___________________________#