_________________________#______________
_wh______________________#______________
_________________________#______________
________________________________________
________e_______________________________
________________________________________
_________________________#______________
_________________________#______________
_________________________#______________
_________________________#______________
####ff##################################
__________________________________#_____
__________________________________#_____
__________________________________#_____
________________________________________
________________________________________
________________________________________
__________________________________#_____
__________________________________#_____
#############################__#########
________________________________________
________________________________________
________________________________________
________________________________________
#######__###____________________________
___________#____________________________
___________#____________________________
___________#____________________________
___________#_______________P____________
___________#____________________________