________________________________________
________________________________________
________________________________________
________________________________________
________________________________________
________________________________________
________________________________________
________________________________________
________________________________________
________________________________________
________________________________________
________________________________________
________________________________________
#_p_______________#_______________e____#
________________________________________
________________________________________
________________________________________
________________________________________
________________________________________
________________________________________
________________________________________
________________________________________
________________________________________
________________________________________
________________________________________
########################################
#__ff___ff___ff___#___________________w#
#__ff___ff___ff___#____________________#
#__ff___ff___ff___#____________________#
#__ff___ff___ff___#_______e____________#