x#######################x##############x
x_____________________ff#h_____________x
x_____________________________________wx
x______________________________________x
x_______________________xh_____________x
x#####__###############################x
x______________________________________x
x______________________________________x
x______________________________________x
x_________________#____________________x
x______________________________________x
x______e_______________________________x
x______________________________________x
x______________x###____________e_______x
xf_____________x_______________________x
xff____________x_______________________x
xfff___________xh______________________x
x#########################__############
xe_____ff____________________h__________
#______ff_______________________________
________________________________________
________________________________________
_______ff_______________________________
________f_______________________p_______
_______hf_______________________________
x#################x####################x
x__ff___ff___ff___x____________________x
x__ff___ff___ff___x____________________x
x__ff___ff___ff___x_______e____________x
x__ff___ff___ff___x____________________x